00000000
00000000
00000S00
00001111
00000000
00000000
10000F01
11111111